j	j
顶点	顶点
wangdao	Qingdao
你好	你好
haode	haole
history	history
genreic	genseric
ok	ok
national	national
xixi	xiii
Guangzhou	Guangzhou
中国人民银行	中国人民银行
shenzhen	Shenzhen
xxxx	xxx
网达	亨达
排	排
ixxx	iphonexx
chat	chat
nation	nation
iph	iphone
中国	中国
k	kA
王道‘	王道
中共革命	闹革命
王到	拣到
顶你肺	顶点
hexx	hexa
hahah	haha
histor	istor
OK	OK
serious	serious
abdcd	abdc
sver	sver
heoo	hcoo
hello	hello
guangzhou	guangzhou
natia	nativ
nihao	nia
newyork	Newyork
王道	王道
